11111111111111111111
100000000000P0000001
10000000000001000001
10000000111100000101
11100000000000000001
11111111111111111111