1111111111111111
1000000P00000001
1111111111011111
11111E0001C11111
1111111111111111