
111111111111111111111111111111111111
100000000000P00000000000000000000001
1000E00000000000000P0000000000000001
10000000111100000000000011000C000001
1110000000000000000E1111000000000001
111111111111111111111111111111111111
