111111111111111111111111111111
100000000000P00000000000000001
1000E000C000000000000000000001
10000000111100000011000C000001
1110000000000E1111000000000001
10000000111100000011000C000001
10000000000C000000110000000001
111110000000000000000000000001
1111100000000CC000000000111001
100000000000000000000000111001
100000001111000000110000000001
111111111111111111111111111111