1111111111111111111
1000000000000000001
1000E00000000000001
100000001110C000001
1110000000000P00001
1111111111111111111